64 24
0000000000000000000000000000000000000000000000000000000000000000
0000000000000000000000000000000000000000000000001100000000000000
0000000000000000000000000000111111000000000000011111000000000000
0000000000000000000000000001111111100000000000001111100000000000
0000000000000000000000000001111111110000000000000111111100000000
0000000000000000000000000000111111110000000000000011111100000000
0000000000000000000000000000011111110000000000111111111110000000
0000000000000000000000000000001111000000000000111111111110000000
0000000011111111000000000000000000000000001111111111111111000000
0000001111111111111100000000000000000000111111111111111111000000
0000111111111111111111100000000000000011111111111100111111110000
0001111111111111111111100000000000000011111111110000111111110000
0011111111111111111111110000000000000001111111110001111111100000
0011111111111111111111100000000000000001111111111000111111100000
0011111111111110111111100000000000000011111111111100111111110000
0011111111111100111111100000000000000011111111111101111111110000
0000111111110000111111110000000000000001111111111111111111110000
0000001111111001111111110000000000000001111111111111111111110000
0000111111111111111111110000000000000011111111111111111111110000
0000111111111111111111110000000000000011111111111111111111110000
0001111111111111111111100000000000000001111111111111111111100000
0001111111111111111110000000000000000001111111111111111110000000
0000001110000000000000000000000000000000011110000000000000000000
0000000000000000000000000000000000000000000000000000000000000000
